0000000000000000
0000000000000000
0011001100110000
0000000000000000
1111111111111111
1111111111111111